111111111111111111
10000100P00000C001
11111100110100C001
100000000001111001
100001111111001001
100000000000001001
100001111111100001
111100000000001111
111111111111111111