111111111111111111
10000100000000C001
11111100110100C001	
10000100000000C001	
11111100110100C001
100000000001111001		
100001111111001001	
10000000C000001001
100001111111100001
111100000000001111	
111111111101111111
10000100000000C001	
11111100110100C001
100000000001111001
100001111111001001
100000000000001001
100001111111100001	
111100000000001111		
111100111111111111
100000P00001111001
100001111111001001
10E000000000001001
100001111111100001
111100000000001111
111111111111111111
