111111111111111111
111100000000000001
10000000P001000001
100000000001000001
100000000001000001
100000000001000001
111100000000000001
111111111111111111