11111111
10C0CC01
1P00CC01
110CCC01
1E00C0L1
11111111
