1111111111111111
1CCCCPC000000001
1E1111C000000001
1CC11CC000000001
1CCLCCC000000001
1111111111111111
