11111111
100P0001
100L0001
100C0001
100000E1
11111111
