11111111
1CCCCPC1
1E1111C1
1CC11CC1
1CCLCCC1
11111111
