11111111
1PC0CC01
1100CC01
100CCC01
1E00CCL1
11111111
