11111
1PC01
11001
10001
1E001
11111