1111111111111111
1CCCCPC000000001
1E1111C00RR0RR01
1CC11CC000000001
1CCLCCC00GG0GG01
1CCLCCC000000001
1111111RRRGGGBB1
1CCCC0C000000001
101111C00BB0BB01
1111111111111111
