111111
1P00C1
101GC1
1B01E1
111111