111111
1P00C1
101L01
1CC0E1
111111